1751,1752,1751,1752,1751,1752,1751,1752,1751,1752,1751,1752,1751,1752,1751,1752,1751,1752,1751,1752,1751,1752,1751,1752,1751,1752,1751,1752,1751,1752
1851,1852,1851,1852,1851,1852,1851,1852,1851,1852,1851,1852,1851,1852,1851,1852,1851,1852,1851,1852,1851,1852,1851,1852,1851,1852,1851,1852,1851,1852
1751,1752,1751,1752,1751,1752,1751,1752,1751,1752,1751,1752,1751,1752,1751,1752,1751,1752,1751,1752,1751,1752,1751,1752,1751,1752,1751,1752,1751,1752
1851,1852,1851,1852,1851,1852,1851,1852,1851,1852,1851,1852,1851,1852,1851,1852,1851,1852,1851,1852,1851,1852,1851,1852,1851,1852,1851,1852,1851,1852
1751,1752,1751,1752,1751,1752,1751,1752,1751,1752,1751,1752,1751,1752,1751,1752,1751,1752,1751,1752,1751,1752,1751,1752,1751,1752,1751,1752,1751,1752
1851,1852,1851,1852,1851,1852,1851,1852,1851,1852,1851,1852,1851,1852,1851,1852,1851,1852,1851,1852,1851,1852,1851,1852,1851,1852,1851,1852,1851,1852
1751,1752,1751,1752,1751,1752,1751,1752,1751,1752,1751,1752,1751,1752,1751,1752,1751,1752,1751,1752,1751,1752,1751,1752,1751,1752,1751,1752,1751,1752
1851,1852,1851,1852,1851,1852,1851,1852,1851,1852,1851,1852,1851,1852,1851,1852,1851,1852,1851,1852,1851,1852,1851,1852,1851,1852,1851,1852,1851,1852
1751,1752,1751,1752,1751,1752,1751,1752,1751,1752,1751,1752,1751,1752,1751,1752,1751,1752,1751,1752,1751,1752,1751,1752,1751,1752,1751,1752,1751,1752
1851,1852,1851,1852,1851,1852,1851,1852,1851,1852,1851,1852,1851,1852,1851,1852,1851,1852,1851,1852,1851,1852,1851,1852,1851,1852,1851,1852,1851,1852
1751,1752,1751,1752,1751,1752,1751,1752,1751,1752,1751,1752,1751,1752,1751,1752,1751,1752,1751,1752,1751,1752,1751,1752,1751,1752,1751,1752,1751,1752
1851,1852,1851,1852,1851,1852,1851,1852,1851,1852,1851,1852,1851,1852,1851,1852,1851,1852,1851,1852,1851,1852,1851,1852,1851,1852,1851,1852,1851,1852
1751,1752,1751,1752,1751,1752,1751,1751,1752,1751,1751,1751,1751,1751,1751,1752,1751,1751,1751,1752,1751,1752,1751,1752,1751,1752,1751,1752,1751,1752
1851,1852,1851,1852,1851,1852,1851,1851,1852,1851,1851,1851,1851,1851,1851,1852,1851,1851,1851,1852,1851,1852,1851,1852,1851,1852,1851,1852,1851,1852
1751,1752,1751,1752,1751,1752,1751,1752,1751,1752,1751,1752,1751,1752,1751,1752,1751,1752,1751,1752,1751,1752,1751,1752,1751,1752,1751,1752,1751,1752
1851,1852,1851,1852,1851,1852,1851,1852,1851,1852,1851,1852,1851,1852,1851,1852,1851,1852,1851,1852,1851,1852,1851,1852,1851,1852,1851,1852,1851,1852
1751,1752,1751,1752,1751,1752,1751,1752,1751,1752,1751,1752,1751,1752,1751,1752,1751,1751,1751,1752,1751,1752,1751,1752,1751,1752,1751,1752,1751,1752
1851,1852,1851,1852,1851,1852,1851,1852,1851,1852,1851,1852,1851,1852,1851,1852,1851,1851,1851,1852,1851,1852,1851,1852,1851,1852,1851,1852,1851,1852
1751,1752,1751,1752,1751,1752,1751,1752,1751,1752,1751,1752,1751,1752,1751,1752,1751,1752,1751,1752,1751,1752,1751,1752,1751,1752,1751,1752,1751,1752
1851,1852,1851,1852,1851,1852,1851,1852,1851,1852,1851,1852,1851,1852,1851,1852,1851,1852,1851,1852,1851,1852,1851,1852,1851,1852,1851,1852,1851,1852
1751,1752,1751,1752,1751,1752,1751,1752,1751,1752,1751,1752,1751,1752,1751,1752,1751,1752,1751,1752,1751,1752,1751,1752,1751,1752,1751,1751,1751,1752
1851,1852,1851,1852,1851,1852,1851,1852,1851,1852,1851,1852,1851,1852,1851,1852,1851,1852,1851,1852,1851,1852,1851,1852,1851,1852,1851,1851,1851,1852
1751,1752,1751,1752,1751,1752,1751,1752,1751,1752,1751,1752,1751,1752,1751,1752,1751,1752,1751,1752,1751,1752,1751,1752,1751,1752,1751,1752,1751,1752
1851,1852,1851,1852,1851,1852,1851,1852,1851,1852,1851,1852,1851,1852,1851,1852,1851,1852,1851,1852,1851,1852,1851,1852,1851,1852,1851,1852,1851,1852
1751,1752,1751,1752,1751,1752,1751,1752,1751,1752,1751,1752,1751,1752,1751,1752,1751,1752,1751,1752,1751,1752,1751,1752,1751,1752,1751,1752,1751,1752
2204,2205,2206,2207,2204,2205,2206,2207,2204,2205,2206,2204,2205,2206,2204,2205,2204,2204,1905,2205,2206,2204,2204,2205,2204,2204,2204,2204,2205,2206
2304,1905,1906,2307,2304,2305,2306,2307,2304,2305,2306,2304,1911,1912,2304,2305,2304,2304,2304,2305,2306,2304,2304,2305,2304,1905,1906,2304,2305,2306
2404,2405,2406,2407,2404,2405,1911,1912,2404,2405,2406,2404,2405,2406,2404,2405,2404,2404,2404,2405,2406,2404,2404,2405,2404,2404,2404,2404,2405,2406
2304,2304,2305,2306,2307,2307,2304,2305,2306,2307,2304,2305,2306,1911,1912,2306,2307,2304,2304,2305,2304,1905,1906,2305,2306,2307,2304,2305,2306,1911
2404,2404,2405,2406,1911,1912,2404,2405,2406,2407,2404,2405,2406,2404,2405,2406,2407,2404,2404,2405,2404,2405,2404,2405,2406,2407,2404,2405,2406,2407
