1751,1752,1751,1752,1751,1752,1751,1752,1751,1752,1751,1752,1751,1752,1751,1752,1751,1752,1751,1752,1751,1752,1751,1752,1751,1752,1751,1752,1751,1752
1851,1852,1851,1852,1851,1852,1851,1852,1851,1852,1851,1852,1851,1852,1851,1852,1851,1852,1851,1852,1851,1852,1851,1852,1851,1852,1851,1852,1851,1852
1751,1752,1751,1752,1751,1752,1751,1752,1751,1752,1751,1752,1751,1752,1751,1752,1751,1752,1751,1752,1751,1752,1751,1752,1751,1752,1751,1752,1751,1752
1851,1852,1851,1852,1851,1852,1851,1852,1851,1852,1851,1852,1851,1852,1851,1852,1851,1852,1851,1852,1851,1852,1851,1852,1851,1852,1851,1852,1851,1852
1751,2951,2951,2952,2953,2952,2953,2953,2954,2953,2954,2952,2953,2953,2954,2953,2954,2952,2953,2953,2954,2952,2953,2952,2951,1752,1751,1752,1751,2954
1851,1852,1851,2651,2652,2651,2652,2651,2652,2651,2652,2651,2652,2653,2654,1852,1851,1852,1851,1852,1851,1852,1851,1852,2951,2952,2953,2952,2953,2954
1751,1752,1751,2751,1751,1752,1751,1752,1751,1752,1751,1752,1751,1752,2654,1752,1751,1752,1751,1752,1751,1752,1751,1752,1751,1752,1751,1752,1751,1752
1851,1852,1851,2851,1851,1852,1851,1852,1851,1852,1851,1852,1851,1852,2754,1852,1851,1852,1851,1852,1851,1852,1851,1852,1851,1852,1851,1852,1851,1852
1751,1752,1751,2951,1751,1752,1751,1752,1751,1752,1751,1752,1751,1752,2654,1752,1751,1752,1751,1752,1751,1752,1751,1752,1751,1752,1751,1752,1751,1752
1851,1852,1851,2951,1851,1852,1851,1852,1851,1852,1851,1852,1851,1852,2754,1852,1851,1852,1851,1852,1851,1852,1851,1852,1851,1852,1851,1852,1851,1852
1751,1752,1751,2951,1751,1752,1751,1752,1751,1752,1751,1752,1751,1752,2654,1752,1751,1752,1751,1752,1751,1752,1751,1752,1751,1752,1751,1752,1751,1752
1851,1852,1851,2851,1851,1852,1851,1852,1851,1852,1851,1852,1851,1852,2654,1852,1851,1852,1851,1852,1851,1852,1851,1852,1851,1852,1851,1852,1851,1852
1751,1752,1751,2951,1751,1752,1751,1751,1752,1751,1751,1751,1751,1751,2754,1752,1751,1751,1751,1752,1751,1752,1751,1752,1751,1752,1751,1752,1751,1752
1851,1852,1851,2851,1851,1852,1851,1851,1852,1851,1851,1851,1851,1851,2854,1852,1851,1851,1851,1852,1851,1852,1851,1852,1851,1852,1851,1852,1851,1852
1751,1752,1751,2951,2952,2953,2954,2953,2954,2952,2953,2954,2953,2954,2954,1752,1751,1752,1751,1752,1751,1752,1751,1752,1751,1752,1751,1752,1751,1752
1851,1852,1851,1852,1851,1852,1851,1852,1851,1852,1851,1852,1851,1852,1851,1852,1851,1852,1851,1852,1851,1852,1851,1852,1851,1852,1851,1852,1851,1852
2651,2652,2653,2654,1751,1752,1751,1752,1751,1752,1751,1752,1751,1752,1751,1752,1751,1751,1751,1752,1751,1752,1751,1752,1751,1752,1751,1752,1751,1752
1851,1852,1851,2754,1851,1852,1851,1852,1851,1852,1851,1852,1851,1852,1851,1852,1851,1851,1851,1852,1851,1852,1851,1852,1851,1852,1851,1852,1851,1852
1751,1752,1751,2854,1751,1752,1751,1752,1751,1752,1751,1752,1751,1752,1751,1752,1751,1752,1751,1752,1751,1752,1751,1752,1751,1752,1751,1752,1751,1752
2951,2952,2953,2954,1851,1852,1851,1852,1851,1852,1851,1852,1851,1852,1851,1852,1851,1852,1851,1852,1851,1852,1851,1852,1851,1852,1851,1852,1851,1852
1751,1752,1751,1752,1751,1752,1751,1752,1751,1752,1751,1752,1751,1752,1751,1752,1751,1752,1751,1752,1751,1752,1751,1752,1751,1752,1751,1751,1751,1752
1851,1852,1851,1852,1851,1852,1851,1852,1851,1852,1851,1852,1851,1852,1851,1852,1851,1852,1851,1852,1851,1852,1851,1852,1851,1852,1851,1851,1851,1852
1751,1752,1751,1752,1751,1752,1751,1752,1751,1752,1751,1752,1751,1752,1751,1752,1751,1752,1751,1752,1751,1752,1751,1752,1751,1752,1751,1752,1751,1752
1851,1852,1851,1852,1851,1852,1851,1852,1851,1852,1851,1852,1851,1852,1851,1852,1851,1852,1851,1852,1851,1852,1851,1852,1851,1852,1851,1852,1851,1852
1751,1752,1751,1752,1751,1752,1751,1752,1751,1752,1751,1752,1751,1752,1751,1752,1751,1752,1751,1752,1751,1752,1751,1752,1751,1752,1751,1752,1751,1752
2204,2205,2206,2207,2204,2205,2206,2207,2204,2205,2206,2204,2205,2206,2204,2205,2204,2204,1905,2205,2206,2204,2204,2205,2204,2204,2204,2204,2205,2206
2304,1905,1906,2307,2304,2305,2306,2307,2304,2305,2306,2304,1911,1912,2304,2305,2304,2304,2304,2305,2306,2304,2304,2305,2304,1905,1906,2304,2305,2306
2404,2405,2406,2407,2404,2405,1911,1912,2404,2405,2406,2404,2405,2406,2404,2405,2404,2404,2404,2405,2406,2404,2404,2405,2404,2404,2404,2404,2405,2406
2304,2304,2305,2306,2307,2307,2304,2305,2306,2307,2304,2305,2306,1911,1912,2306,2307,2304,2304,2305,2304,1905,1906,2305,2306,2307,2304,2305,2306,1911
2404,2404,2405,2406,1911,1912,2404,2405,2406,2407,2404,2405,2406,2404,2405,2406,2407,2404,2404,2405,2404,2405,2404,2405,2406,2407,2404,2405,2406,2407
